111111111111111111111111
1E00000000000000000C0001
100000011111111000000001
100000000011000000000001
100C00000011000000000001
100000000011000C00000001
1000000000110000000000P1
111111111111111111111111