11111111111111111111
100P00000C000B000E01
11111111111111111111